######
#..@.#
#.$.$#
###$.#
#~~.~#
######

######
#~~.~#
###..#
#.$$.#
#@.$.#
#.$$.#
#.~#.#
##.#.#
#~...#
######

#...@..
#...$..
#..$.$.
#.$.$.$
#..$.$.
#...$..
#..####
#...~..
#..~.~.
#.~.~.~
#..~.~.
#...~..