######
#~~.~#
###..#
#.$$.#
#@.$.#
#.$$.#
#.~#.#
##.#.#
#~...#
######

..@..
..$..
.$.$.
$.$.$
.$.$.
..$..
.~.~.
.~~~.
.~.~.
..~..