######
#..@.#
#.$.$#
###$.#
#~~.~#
######

########
#.....~#
#..$#.~#
#@$$..~#
#.....~#
#.....$#
#......#
########

######
#~~.~#
###..#
#.$$.#
#@.$.#
#.$$.#
#.~#.#
##.#.#
#~...#
######

##########
######~..#
###~~$.$.#
#@.$.#...#
#.$#.##..#
#..$~....#
####~...##
##########



#############
#.....~.....#
#.#.##$####.#
#....$~.~$..#
#######@#####
       #

########
#####..#
#.$....~#
#.$$#~~@#
#.....##
 ######